╔╔═════════════════════════════════════════════
║║...........................................║║
║║......══╗..............,,,.........══......║║
║║........║............,,,,,,,...............║║
║║........║..╔╗......,,,,,,,,................║║
║║...........║║........,,,.....╔══...........║║
║║...........╚╣................║.............║║
║║............║..............................║║
║║..,,,,..................║......╠════╣......║║
║║...,,,,.................║......,...........║║
═════════════════════════════════════════════╝╝
║║                  ARENE 00                 ║║
║║                                           ║║
═════════════════════════════════════════════╝╝